######################################################################
||                               .                                  ||
||                 %%%%%%%%%%%%%%%%%%%%%%%%%%%%%%                   ||
||        |                                               |         ||
||        %%%%%%%%%%%%%%%%                %%%%%%%%%%%%%%%%%         ||
||                                                                  ||
||        %%%%%%%%%%%%%%%%                %%%%%%%%%%%%%%%%%         ||
||                                                                  ||
||                 |                            |                   ||
||                 %%%%%%%%%%%%%%%%%%%%%%%%%%%%%%                   ||
||                                                        .         ||
||        %%%%%%%%%%%%%%%%       .        %%%%%%%%%%%%%%%%%         || 
||        |                      %                        |         ||
||        %%%%%%%%%%%%%%%%                %%%%%%%%%%%%%%%%%         ||
||                                                                  ||
||                 %%%%%%%%%%%%%%%%%%%%%%%%%%%%%%                   ||
||                                                                  ||
||        %%%%%%%%%%%%%%%%                %%%%%%%%%%%%%%%%%         || 
||                                       |                          ||
||                                      |                           ||
######################################################################