######################################################################  
||                                                                  || 
||   %%%%%%%%%%%%%%%%                %%%%%%%%%%%%%%  |%|     %%%%   || 
||          |%|   |%|     |%|                   |%|  |%|      |%|   || 
||          |%|   |%|     |%|        |%|    .   |%|  |%|      |%|   || 
||          %%%%%%%%      |%|        %%%%%%%%%%%%%%          %%%%   || 
||          |%|           |%|                       |%|             || 
||          %%%%%%%%%%    |%|       %%%%%%%%%%%%    |%|      %%%%   || 
||                 |%|              |%|             |%|       |%|   || 
||                 |%|              |%|      |%|              |%|   || 
||  |%|  |%|%%%|%| |%|  |%|                  |%|          |%| |%|   || 
||  |%|  |%| . |%|      %%%%%%%%%%%%%        |%|          |%|       || 
||  |%|  |%|   |%|                |%|     %%%%%%          |%|       || 
||  |%|                           |%|               |.|   |%|       || 
||  |%|  %%%%%%%%%%%%%%           |%|%%%%%%%%%%     |%|   |%|%%%%%  || 
||                                                  |%|             || 
||                                                                  || 
||  |%|  |%|   |%|      %%%%%%%%%%%%%        |%|    |%|   |%|       || 
||  |%|  |%|   |%|                |%|     %%%%%%    |%|   |%|       || 
||  |%|                           |%|               |%|   |%|       || 
||  |%|  %%%%%%%%%%%%%%           |%|%%%%%%%%%%     |%|   |%|%%%%%  || 
||                                                  |%|             || 
||                                                                  || 
######################################################################