############################################################
|||%||%||%|                                            |%|||
||      |%||%||%||%||%||%||%||%||%||%||%||%||%||%|     |%|||                       
||                                              |%|       ||
||         |%||%|           |%|        |.|                ||
||               |%||%|     |%|        |%|                ||
||         |%|              |%|                |%|        ||
||         |%|                                 |%|        ||
||         |%||%||%||%||%|         |%||%||%||%||%|        ||
||                     |%||%||%||%||%|                    ||
||         |%|                                |%|         ||
||          |%|  |%|                  |%|   |%|   |.|     ||
||           |%| |%||%||%||%||%||%||%||%| |%|   |%|||%|   ||
||                                                        ||
||        |%||%|                           |%| |%|        ||
||      |%|  |%|                           |%|   |%|      ||
||           |%||%|         |.|         |%||%|            ||
||      |%|     |%|         |%|         |%|      |%|      ||   
||        |%|   |%||%||%||%||%||%||%||%||%|    |%|        ||
||                                                        ||
||                 |%|                                    ||
############################################################